1111111111
1000200001
1001111101
1001111101
1000000001
1000000001
1000000001
1000000001
1000300001
1111111111