1111111011
1010200001
1011111001
1001000091
1011900001
1030000001
1000901111
1000008001
1080300001
1111111111